000000000000000000000000000000000000000000000000000000000000
000000000000000000000000000000000000000000000000000000000000
000000000000000000000000000000000000000000070000000000000000
000000000000000000000000000000000000000000007000000000000000
050000000300000000000000000000000000000000070000000000000000
000000000300000000000000006000060000600002222222222222222002
222222222222222044000000022222222222222222307000000000000003
000000000000000000000000037000000000030000300000000000000003
000000000000000000000000037000000000030000300222222222222223
000000000000000000000000000000000000000000300700000000000003
000000000000003000000000000000000000000000300000000000000003
000000000000003044000000030000030000030000322222222222222003
000000000600003000000000030000030000030000007000000000000003
000000000300003000000000030000030000030000000000000000000003
111111111111111000000000030000030000031111111111111111111111
