00000000000000000000000000000000000000000000000000000000000000
00000000000000000000000000000000000000000000000000000000000000
00000000000000000000000000000000000000000000000000000000000000
00000000000000000000000000000000000000000000000000000000000000
00000000000000000000000000000000000000000000000000000000000000
00000000000000000000000000000000000000000000000000000000000000
00000000000000000000000000000000000000000000000000000000000000
00000000000000000000000004400000000000000030000000000300000000
00000000000000000000000000000000000022000037000000000300000000
00000000000030000000000000030000000000000030000000000300000000
00000000002230000000000000030002200000000030000000000300000000
00000000000030000000000000030000000000000037000000000300000000
00000022000030000000000000030000000022000030000000000000000050
00000000000030000000000000030000000000000030000000000000000000
11111111111111111111111111111111111111111111111111111111111111
