00000000000000000000000000000000000000000000000000000000000000000000000000000000000
00000000000000000000000000000000000000000000000000000000000000000000000000000000000
00000000000000000000000000000000000000000000000000000000000000000000000000000000000
00000000000000000000000000000000300000000000000003000000000000000000000000000000000
00000000000000000000000000000000300000000000000003000000000000000000000000000000000
00000000022222222222222000222000300000000000000003000000000000000000000000000000000
00000000030000000000003000000000360000000000000003000000000003000000000000000000000
00000000030000000000003000000000322222222222222003000000000023000000000000000000000
00000000030700000000003022000220300000000000000003000000000223000000000000000000000
00000000030000000000003000000000300000000000000003000000002223000000000000000000000
00000000030000000000003000000000300600000000000003000000022223070000000000000000000
00000000030000000000003000222000300222222222222223000000222223000000000000000000000
00000000022222200222222000000000300000000000000000000002222223000000000000000000050
00000000060000000000000000000000360000000000000000000022222223000000000000000000000
11111111111111111111111111111111111111111111111111111111111111000000000000111111111
