00000000000000000000000000000000000000000000000
00000000000000000000000000000000000000000000000
00000000000000000000000000000000000000000000000
00000000000000000000000000000000000000000000000
00000000000000000000000000000000000000000000000
00000000000000000000000000000000000000000000000
00000000000000000000000000003000000030000000000
00000000000000000000000000003000000030000000000
00000000000000000000000300003000000030000000000
00000000000300000300000300003000000030000000000
00000000000300000300000300003000000000000000000
00000000022300000300000300003000000000000000000
00000000000300000300000300003000000030000000050
00000000000360000360000360003600000030000000000
11111111111111111111111111111111111111111111111
