0000000000000000000000000000000000000000000000
0000000000000000000000000000000000000000000000
0000000000000000000000000000000000000000000000
0000000000000000000000000000000000000000000000
0000000000000000000000000000000000000000000000
0000000000000000000000000000000000000000000000
0000000000000000000000000000000000000000000000
0000000000000000000000000000000000000000000000
0000000000000000070000000000000000000000000000
0000000000070000000000007000000000000000000000
0000000003000000000000000000000004403000000000
0000000023000000000000000000000000003200000000
0000000223007000000000007000000000003220000050
0000002223000000000000000000000000003222000000
1111111111000000000000000000000000001111111111
