0000000000000000000000000000000000000000000000000000000000000000000000
0000000000000000000000000000000000000000000000000000000000000000000000
0000000000000000000000000000000000000000000000000000000000000000000000
0000000000000000000000000000000000000000000000000000000000000000000000
0000000000000000000000000000000000000000000000000000000000000000000000
0000000000000000000000000000000000000000000000000000000000000000000000
0000000000000000000000000000000000000000000000000000000000000000000000
0000000000000000000000000000000000000007000000000000000000000000000000
0000000000000000000006000000007000000000000000000000000000000000000000
0000000000000000600003000000000000700000000000000000030000000000000000
0000000000000000200003000000304400000000000000000000030000003000000000
0000000000060000000003000000300000000000000000000000030000003000000000
0000000002220000000003000000320000000000000000000000030000003000000050
0000000000000000000003000000322000000000000000000000030000003000000000
1111111111110000000003000000111111111111111111111111111111111111111111
