00000000000000000000000000000000000000000000000000000000000000000
00000000000000000000000000000000000000000000000000000000000000000
00000000000000000000000000000000000000000000000000000000000000000
00000000000000000000000000000000000000000000000000000000000000000
00000000000000000000000000000000000000000000000000000000000000000
00000000000000000000000000000000000000000000000000000000000000000
00000000000000000000000000000000000220000000000000000000000000000
00000000000000000000000000000000000000000000000000000000000000000
00000000000000003000000000304000000040000000030000000003000000000
00000000000000003700000000300000000000000000030000000003000000000
00000000000220003000000000300000000000000000030000000003000000000
00000000000000003000000000300000000000000000030000000003000000000
00000022000000003000000000300000000000000000030000000003000000050
00000000000000003000000000300000000000000000036000000000000000000
11111111111111111111111111111111111111111111111111111111111111111
