0000000000000000000000000000000000000000000000000
0000000000000000000000000000000000000000000000000
0000000000000000000000000000000000000000000000000
0000000000000000000000000000000000000000000000000
0000000000000000000000000000000000000000000000000
0000000000000000000000000000000000000000000000000
0000000000000000000000000000000000000000000000000
0000000000000000000000000000000000000000000000000
0000000000000000000000000000000000000000000000000
0000000000000000000000000000003000000000300000000
0000000000000000000000000220003000000000300000000
0000000000000000000000000000003000000022300000000
0000000000000000000022000000003000000000300000050
0000000000000000000000000000003600000000300000000
1111111111111111111111111111111111111111111111111


